############################
#OOOOOOOOOOOO##OOOOOOOOOOOO#
#C####O#####O##O#####O####C#
#O####O#####O##O#####O####O#
#O####O#####O##O#####O####O#
#OOOOOOOOOOOOOOOOOOOOOOOOOO#
#O####O##O########O##O####O#
#O####O##O########O##O####O#
#OOOOOO##OOOO##OOOO##OOOOOO#
######O#####E##E#####O######
######O#####E##E#####O######
######O##EEEEEEEEEE##O######
######O##E########E##O######
######O##E########E##O######
EEEEEEOEEE########EEEOEEEEEE
######O##E########E##O######
######O##F########F##O######
######O##EEEEEEEEEE##O######
######O#####E##E#####O######
######O#####E##E#####O######
#OOOOOO##OOOO##OOOO##OOOOOO#
#O####O##O########O##O####O#
#O####O##O########O##O####O#
#OOOOOOOOOOOOPOOOOOOOOOOOOO#
#O####O#####O##O#####O####O#
#O####O#####O##O#####O####O#
#C####O#####O##O#####O####C#
#OOOOOOOOOOOO##OOOOOOOOOOOO#
############################